1,1,1,1,1,1,1,1,1,1,1,1,1,1,1,1,1,1,1,1,1,1
1,7,0,0,0,0,0,0,0,1,0,0,0,0,0,0,1,0,0,0,0,1
1,0,1,1,0,1,1,0,0,1,0,1,1,1,0,0,1,0,1,1,0,1
1,0,0,1,0,0,0,0,2,0,0,0,0,1,0,0,0,0,0,1,6,1
1,1,0,1,1,1,0,1,1,1,0,1,0,1,1,1,0,1,0,1,0,1
1,0,0,0,0,1,0,0,0,1,0,1,0,0,0,1,0,1,0,0,0,1
1,0,1,1,0,1,1,1,0,1,0,1,1,1,0,1,0,1,1,1,0,1
1,0,1,0,0,0,0,1,0,0,0,0,2,1,0,0,0,0,0,1,0,1
1,0,1,0,1,1,0,1,1,1,1,0,1,1,1,1,0,1,0,1,0,1
1,0,0,0,1,0,0,0,0,0,1,0,0,0,0,1,0,1,0,6,0,1
1,1,1,0,1,0,1,1,1,0,1,1,1,1,0,1,0,1,0,1,0,1
1,0,0,0,1,0,0,0,1,0,0,0,0,1,0,0,0,1,0,1,0,1
1,0,1,1,1,1,1,0,1,1,1,1,0,1,1,1,0,1,0,1,0,1
1,0,1,8,0,0,1,0,0,0,2,1,0,0,0,1,0,0,0,1,0,1
1,0,1,1,0,1,1,1,1,0,0,1,1,1,0,1,1,1,0,1,6,1
1,0,0,0,0,0,0,0,0,0,3,0,0,5,0,0,0,0,0,0,0,1
1,1,1,1,1,1,1,1,1,1,1,1,1,1,1,1,1,1,1,1,1,1