1,1,1,1,1,1,1,1,1,1,1,1,1,1,1,1,1,1,1,1,1,1
1,7,0,1,0,0,0,1,0,0,0,0,0,1,0,0,0,0,0,1,0,1
1,0,0,1,0,1,0,1,0,1,1,1,0,1,0,1,1,1,0,1,0,1
1,0,2,1,0,1,0,0,0,1,0,0,0,1,0,0,0,1,0,1,6,1
1,0,1,1,0,1,1,1,0,1,0,1,1,1,1,1,0,1,0,1,0,1
1,0,0,0,0,0,0,1,0,0,0,1,9,9,9,1,0,1,0,0,0,1
1,1,1,1,1,1,0,1,1,1,0,1,9,10,9,1,0,1,1,1,0,1
1,0,0,0,0,1,0,0,0,1,0,0,9,9,9,0,0,0,0,1,0,1
1,0,1,1,0,1,1,1,0,1,1,1,0,1,1,1,1,1,0,1,0,1
1,0,1,0,0,0,0,1,0,0,0,1,0,0,0,0,0,1,0,1,0,1
1,0,1,0,1,1,0,1,1,1,0,1,1,1,1,1,0,1,0,1,0,1
1,0,0,0,0,1,0,0,0,1,0,0,2,0,0,1,0,1,0,0,0,1
1,1,0,1,0,1,1,1,0,1,1,1,1,1,0,1,0,1,1,1,0,1
1,0,0,1,0,0,0,1,0,0,0,0,0,1,0,0,0,1,0,1,0,1
1,0,1,1,1,1,0,1,1,1,0,1,0,1,1,1,0,1,0,1,6,1
1,0,0,0,0,0,0,0,0,0,3,0,0,0,0,5,0,0,0,0,0,1
1,1,1,1,1,1,1,1,1,1,1,1,1,1,1,1,1,1,1,1,1,1
