1,1,1,1,1,1,1,1,1,1,1,1,1,1,1,1,1,1,1,1,1,1
1,7,0,1,0,0,0,1,0,2,0,1,0,0,0,1,0,0,0,0,0,1
1,0,0,1,0,1,0,1,0,1,0,1,0,1,0,1,1,1,1,1,0,1
1,0,1,1,0,1,0,0,0,1,0,0,0,1,0,0,0,0,0,1,0,1
1,0,1,0,0,1,1,1,0,1,1,1,0,1,1,1,1,1,0,1,0,1
1,0,1,0,0,0,0,1,0,0,0,1,0,0,0,0,0,1,0,0,6,1
1,0,1,0,1,1,0,1,1,1,0,1,1,1,1,1,0,1,1,1,0,1
1,0,0,0,1,2,0,0,0,1,0,0,0,0,0,1,0,0,0,1,0,1
1,1,1,0,1,1,1,1,0,1,1,1,1,1,0,1,1,1,0,1,0,1
1,0,0,0,0,0,0,1,0,0,0,0,5,1,0,0,0,1,0,0,0,1
1,0,1,1,1,1,0,1,1,1,1,0,1,1,1,1,0,1,1,1,0,1
1,0,0,0,0,1,0,0,0,0,1,0,0,0,0,1,0,0,0,1,0,1
1,1,1,1,0,1,1,1,1,0,1,1,1,1,0,1,1,1,0,1,0,1
1,0,0,1,0,0,0,0,1,0,0,0,3,1,0,0,0,0,0,1,0,1
1,6,0,1,1,1,1,0,1,1,1,0,1,1,1,1,1,1,0,1,0,1
1,0,0,0,0,0,0,0,0,2,0,0,0,0,0,0,0,0,0,0,0,1
1,1,1,1,1,1,1,1,1,1,1,1,1,1,1,1,1,1,1,1,1,1
